1111111111
1.....P..1
111Z...1.1
11Z1..1.11
1..1..1.11
1.111....1
1.1.1.1..1
1......1.1
1.111..1.1
1111111111